############################################
#...@................#.....................#
#....................#.....................#
#..........................................#
#....................#.....................#
#....................#.....................#
#....................#.....................#
#....................#.....................#
######################.....................#
                     #.....................#
                     #.....................#
                     #.....................#
                     #.....................#
                     #.....................#
                   ###.....................###
                  #...........................#
                  #...........................#
              ####............................####
              #..................................#
              #..................................#
              ####################################