Doors
0 Level1.txt 20 3 0 end
######################
#....................#
#....................0
#....................#
#....................#
#....................#
######################