Doors
0 Level1.txt 21 2 end
######################
#....................#
#...................@0
#....................#
#....................#
#....................#
######################