######################
#...@................#
#....................#
#....................#
#....................#
#....................#
#....................#
#....................#
######################
